25 25
100 100
14 14 14 14 14 14 14 14 14 14 14 14 14 14 14 14 14 14 14 14 14 14 14 14 14
14 2  2  2  2  2  2  2   14  14  14  14  14  14  2  2  2  2  2  2  2  2  14  14  14
14 2  2  2  2  2  2  2   14  14  14  14  14  14  2  2  2  2  2  2  2  2  2  14  14
14 2  2  2  2  2  2  2   14  14  14  14  14  14  2  2  2  2  2  2  2  2  2  14 14
14 14 2  2  2  2  2  2   14  14  14  14  14  2  2  2  2  2  2  2  2  2  2  2  14
14 14  14 14 2  2  2  2   2   14 14  14 14  2  2    2  2  2  2  2  2  2  2  2  14
14 14  14  14  14 2  2  2   2   2  2  2  2  2  2  2  2  2  2  2  2  2  2  2  14
14 14  14  14  14 2  2  2   2   2  2  2  2  2  2  2  2  2  2  2  2  2  2  2  14
14 14  14  14  14 2  2  2   2   2  2  2  2  2  2  2  2  2  2  2  2  2  2  2  14
14 14  14  14  14 2  2  2   2   2  2  2  2  2  2  2  2  2  2  2  2  2  2  2  14
14 14  14  14  14 2  2  2   2   2  2  2  2  2  2  2  2  2  2  2  2  2  2  2  14
14 14  14  14  14 2  2  2   2   2  2  2  2  2  2  2  2  2  2  2  2  2  2  2  14
14 14  14  14  14 2  2  2   2   2  2  2  2  2  2  2  2  2  2  2  2  2  2  2  14
14 14  14  14  14 2  2  2   2   2  2  2  2  2  2  2  2  2  2  2  2  2  2  2  14
14 14  14  14  14 2  2  2   2   2  2  2  2  2  2  2  2  2  2  2  2  2  2  2  14
14 14  14  14  14 2  2   2   2  2  2  2  2  2  2  2  2  2  2  2  2  2  2  2  14
14 2  2  2  2  2  2  2   2   2  2  2  2  2  2  2  2  2  2  2  2  2  2  2  14
14 2  2  2  2  2  2  2   2   2  2  2  2  2  2  2  2  2  2  2  2  2  2  2  14
14 2  2  2  2  2  2  2   2   2  2  2  2  2  2  2  2  2  2  2  2  2  2  2  14
14 14  14  14  14  14  14  14  2  2  14 14  14  2  2  2  2  2  2  14  14  14  14  14  14
14 14  14  14  14  14  14  14  2  2  14  14  14  14  2  2  2  2  2  14  14  14  14  14  14
14 14  14  14  14  14  14  14  2  2  14  14  14  14  14  2  2  2  2  14  14  14  14  14  14
14 14  14  14  14  14  14  14  2  2  14  14  14  14  14  14  2  2  2  14  14  14  14  14  14
14 14  14  14  14  14  14  14  2  2  14  14  14  14  14 14  14  2  2  14  14  14  14  14  14
14 14 14 14 14 14 14 14 14 14 14 14 14 14 14 14 14 14 14 14 14 14 14 14 14