25 25
200 200
2 2  2 20 20 20 20 20 20 20 20 20 20 20 20 20 20 20 20 20 20 20 20 20 5
8 2  2  2  2  2  2  2  2  2  2  2  2  2  2  2  2  2  2  2  2  2  2  2  9
8 2  2  2  2  9  2  2  2  2  2  2  2  2  2  2  2  2  2  2  2  2  2  2  9
8 2  2  2  2  2  2  2  2  2  2  2  2  2  2  2  2  2  2  2  2  2  2  2  9
8 2  2  2  2  2  2  2  2  22 22 2  2  2  2  2  2  2  2  2  2  2  2  2  9
8 2  2  2  2  2  2  2  2  22 22 2  2  2  9  2  2  2  2  2  2  2  2  2  9
8 2  2  2  2  2  2  2  2  2  2  2  2  2  2  2  2  2  2  2  2  2  2  2  9
8 2  2  2  2  2  2  2  2  2  2  2  2  2  2  2  2  2  2  2  2  2  2  2  9
8 2  2  2  2  2  2  2  9  2  2  2  2  2  2  2  2  2  2  2  2  2  2  2  9
8 2  2  2  2  2  9  9  9  2  2  2  2  2  2  2  2  2  2  2  2  2  2  2  9
8 2  2  2  2  2  9  2  2  2  2  2  2  2  2  2  2  2  2  2  2  2  2  2  9
8 2  2  2  2  2  9  2  2  2  2  9  2  2  2  2  2  2  2  2  2  2  2  2  9
8 2  2  2  2  2  2  2  2  2  2  2  2  2  2  2  2  2  2  2  2  2  2  2  9
8 2  2  2  2  2  2  2  2  2  2  2  2  2  2  2  2  2  2  2  2  2  2  2  9
8 2  2  2  2  2  2  2  2  2  2  2  2  2  2  2  2  2  2  2  2  2  2  2  9
8 2  2  2  2  2  2  2  2  2  2  2  2  2  2  2  2  2  2  2  2  2  2  2  9
8 2  2  2  2  2  2  2  2  2  2  2  9  2  2  2  2  2  2  2  2  2  2  2  9
8 2  2  2  2  2  2  2  2  2  2  2  2  2  2  2  2  2  2  2  2  2  2  2  9
8 2  2  2  2  2  2  2  2  2  2  2  2  2  2  2  2  2  2  2  2  2  2  2  9
8 2  2  2  2  2  2  2  2  2  2  2  2  2  2  2  2  2  2  2  2  2  2  2  9
8 2  2  2  2  2  2  2  2  22 2  2  2  2  2  2  2  2  2  2  2  2  2  2  9
8 2  2  2  2  2  2  2  2  2  2  2  2  2  2  2  2  2  2  2  2  2  2  2  9
8 2  2  2  2  2  2  2  2  2  2  2  2  2  2  2  2  2  2  2  2  2  2  2  9
8 2  2  2  2  2  2  2  2  2  2  2  2  2  2  2  2  2  2  2  2  2  2  2  9
7 22 22 22 22 22 22 22 22 22 22 22 22 22 22 22 22 22 22 22 22 22 22 22 6