25 25
200 200
 13  13  13  13  13  13  13  13  13  13  13  13  13  13  13  13  13  13  13  13  13  13  13   13  13
 13  12  12  12  12  13  13  13  13  13  13  13  13  13  13  13  13  13  13  13  13  13  13   13  13
 13  12  12  12  12  12  12  12  12  12  12  12  12  12  12  12  12  12  12  13  13  13  13   13  13
 13  12  12  12  12  12  12  12  12  12  12  12  12  12  12  12  12  12  12  12  13  13  13   13  13
 13  12  12  12  12  12  12  12  12  12  12  12  12  12  12  12  12  12  12  12  12  13  13   13  13
 13  12  12  12  12  12  12  12  12  12  12  12  12  12  12  12  12  12  12  12  12  12  13   13  13
 13  12  12  12  12  12  12  12  12  12  12  12  12  12  12  12  12  12  12  12  12  12  12   13  13
 13  12  12  12  12  12  12  12  12  12  12  12  12  12  12  12  12  12  12  12  12  12  12   13  13
 13  12  12  12  12  12  12  12  12  12  12  12  12  12  12  12  12  12  12  12  12  12  12   13  13
 13  12  12  12  12  12  12  12  12  12  12  12  12  12  12  12  12  12  12  12  12  12  12   13  13
 13  12  12  12  12  12  12  12  12  12  12  12  12  12  12  12  12  12  12  12  12  12  12   13  13
 13  12  12  12  12  12  12  12  12  12  12  12  12  12  12  12  12  12  12  12  12  12  12   13  13
 13  12  12  12  12  12  12  12  12  12  12  12  12  12  12  12  12  12  12  12  12  12  12   13  13
 13  12  12  12  12  12  12  12  12  12  12  12  12  12  12  12  12  12  12  12  12  12  12   13  13
 13  12  12  12  12  12  12  12  12  12  12  12  12  12  12  12  12  12  12  12  12  12  12   13  13
 13  12  12  12  12  12  12  12  12  12  12  12  12  12  12  12  12  12  12  12  12  12  12   13  13
 13  12  12  12  12  12  12  12  12  12  12  12  12  12  12  12  12  12  12  12  12  12  12   13  13
 13  12  12  12  12  12  12  12  12  12  12  12  12  12  12  12  12  12  12  12  12  12  12   13  13
 13  13  12  12  12  12  12  12  12  12  12  12  12  12  12  12  12  12  12  12  12  12  12   13  13
 13  13  13  12  12  12  12  12  12  12  12  12  12  12  12  12  12  12  12  12  12  12  12   13  13
 13  13  13  13  12  12  12  12  12  12  12  12  12  12  12  12  12  12  12  12  12  12  13   13  13
 13  13  13  13  13  12  12  12  12  12  12  12  12  12  12  12  12  12  12  12  12  13  13   13  13
 13  13  13  13  13  13  12  12  12  12  12  12  12  12  12  12  12  12  12  12  13  13  13   13  13
 13  13  13  13  13  13  13  13  13  13  13  13  13  13  13  13  13  13  13  13  13  13  13   13  13
 13  13  13  13  13  13  13  13  13  13  13  13  13  13  13  13  13  13  13  13  13  13  13   13  13